Index,Name,Number Sentences,Readable Sentences,Easy Read Percentage,Total Words,Known Words,Unknown Words,Known Percentage,Total Kanji,Known Kanji,Unknown Kanji,Known Kanji Percentage,Kanji 10+,Known 10+,Known 10+ Percentage,Kanji 5+,Known 5+,Kanji 2+,Known 2+
0,86―エイティシックス― 1,3293,607,18,7025,2300,4725,32,1997,1338,659,67,845,766,90,1181,984,1660,1222
1,86―エイティシックス― 2,2583,435,16,6266,2169,4097,34,1901,1323,578,69,762,697,91,1084,929,1537,1185
2,86―エイティシックス― 3,3303,688,20,6877,2131,4746,30,2001,1317,684,65,850,753,88,1168,966,1604,1180
3,86―エイティシックス― 4,3390,651,19,6610,2168,4442,32,1893,1301,592,68,824,730,88,1126,947,1540,1180
4,86―エイティシックス― 5,3647,681,18,7171,2214,4957,30,2023,1326,697,65,904,794,87,1213,989,1660,1206
5,No Game No Life Vol. 1,3752,1040,27,4836,1947,2889,40,1607,1223,384,76,542,522,96,831,760,1270,1057
6,No Game No Life Vol. 2,3844,997,25,4785,1954,2831,40,1591,1232,359,77,527,510,96,823,755,1245,1051
7,No Game No Life Vol. 3,4221,944,22,4976,1945,3031,39,1585,1214,371,76,597,568,95,861,783,1268,1052
8,No Game No Life Vol. 4,3827,754,19,5284,2011,3273,38,1709,1256,453,73,592,561,94,896,819,1331,1091
9,No Game No Life Vol. 5,4375,894,20,5483,2049,3434,37,1746,1267,479,72,659,623,94,967,861,1403,1121
10,No Game No Life Vol. 6,4857,912,18,5509,2007,3502,36,1732,1271,461,73,767,707,92,1041,911,1421,1124
11,No Game No Life Vol. 7,4533,738,16,6283,2119,4164,33,1885,1322,563,70,722,671,92,1051,908,1540,1198
12,No Game No Life Vol. 8,4886,937,19,5504,1949,3555,35,1766,1256,510,71,676,621,91,999,864,1442,1114
13,No. 6 Vol. 1,2051,735,35,4095,1905,2190,46,1424,1130,294,79,474,459,96,751,696,1118,955
14,No. 6 Vol. 2,2047,699,34,4170,1863,2307,44,1555,1176,379,75,450,434,96,762,696,1195,998
15,No. 6 Vol. 3,1918,540,28,4208,1910,2298,45,1553,1189,364,76,464,447,96,758,697,1200,1021
16,No. 6 Vol. 4,2103,753,35,4102,1790,2312,43,1556,1183,373,76,464,444,95,763,694,1203,993
17,No. 6 Vol. 5,1918,618,32,4268,1777,2491,41,1615,1204,411,74,460,433,94,777,688,1275,1026
18,No. 6 Vol. 6,1949,603,30,3931,1735,2196,44,1519,1158,361,76,437,418,95,722,645,1190,964
19,No. 6 Vol. 7,1979,686,34,3953,1733,2220,43,1495,1132,363,75,414,397,95,685,637,1156,960
20,No. 6 Vol. 8,1856,476,25,4038,1700,2338,42,1518,1154,364,76,437,417,95,721,654,1158,953
21,No. 6 Vol. 9,2042,582,28,3989,1725,2264,43,1549,1173,376,75,432,412,95,729,666,1175,970
22,Re ゼロから始める異世界生活 Vol. 1,3277,644,19,6346,2260,4086,35,1735,1285,450,74,729,689,94,1026,916,1422,1147
23,Re ゼロから始める異世界生活 Vol. 10,3784,864,22,6322,2325,3997,36,1816,1309,507,72,770,736,95,1098,971,1508,1189
24,Re ゼロから始める異世界生活 Vol. 11,4042,929,22,6243,2180,4063,34,1850,1287,563,69,782,713,91,1090,930,1516,1152
25,Re ゼロから始める異世界生活 Vol. 12,3872,882,22,5993,2057,3936,34,1830,1284,546,70,768,693,90,1079,910,1510,1138
26,Re ゼロから始める異世界生活 Vol. 13,3940,997,25,5766,2030,3736,35,1772,1258,514,70,725,669,92,1043,895,1468,1140
27,Re ゼロから始める異世界生活 Vol. 14,3849,834,21,6101,2098,4003,34,1818,1279,539,70,793,726,91,1109,948,1527,1160
28,Re ゼロから始める異世界生活 Vol. 15,3936,852,21,6549,2230,4319,34,1893,1304,589,68,843,773,91,1157,973,1570,1188
29,Re ゼロから始める異世界生活 Vol. 16,3753,577,15,7115,2367,4748,33,1925,1328,597,68,823,779,94,1149,1009,1599,1229
30,Re ゼロから始める異世界生活 Vol. 17,3737,716,19,6923,2222,4701,32,1911,1319,592,69,840,766,91,1177,994,1601,1204
31,Re ゼロから始める異世界生活 Vol. 18,3729,687,18,6243,2105,4138,33,1855,1286,569,69,810,742,91,1107,956,1534,1154
32,Re ゼロから始める異世界生活 Vol. 19,3656,732,20,6743,2146,4597,31,1869,1303,566,69,846,772,91,1161,991,1570,1185
33,Re ゼロから始める異世界生活 Vol. 2,3857,836,21,6652,2325,4327,34,1808,1326,482,73,790,757,95,1077,962,1491,1192
34,Re ゼロから始める異世界生活 Vol. 20,3938,769,19,6560,2154,4406,32,1892,1300,592,68,810,735,90,1168,980,1578,1183
35,Re ゼロから始める異世界生活 Vol. 3,3910,804,20,6594,2299,4295,34,1798,1289,509,71,760,719,94,1072,943,1497,1186
36,Re ゼロから始める異世界生活 Vol. 4,3738,693,18,6756,2293,4463,33,1862,1315,547,70,780,728,93,1105,969,1544,1192
37,Re ゼロから始める異世界生活 Vol. 5,3402,683,20,6462,2187,4275,33,1867,1327,540,71,781,732,93,1103,965,1543,1201
38,Re ゼロから始める異世界生活 Vol. 6,3647,823,22,6139,2135,4004,34,1830,1296,534,70,769,715,92,1072,934,1525,1174
39,Re ゼロから始める異世界生活 Vol. 7,3450,627,18,6252,2137,4115,34,1790,1265,525,70,742,695,93,1082,942,1492,1152
40,Re ゼロから始める異世界生活 Vol. 8,3296,592,17,6509,2128,4381,32,1860,1276,584,68,801,732,91,1120,949,1546,1154
41,Re ゼロから始める異世界生活 Vol. 9,3779,763,20,6584,2222,4362,33,1836,1304,532,71,816,759,93,1133,976,1538,1182
42,WORLD END ECONOMiCA I (電撃文庫),9172,2811,30,8120,2731,5389,33,1910,1374,536,71,951,896,94,1256,1100,1628,1299
43,WORLD END ECONOMiCA II (電撃文庫),7035,2050,29,7934,2734,5200,34,1948,1374,574,70,936,876,93,1215,1076,1631,1289
44,WORLD END ECONOMiCA III (電撃文庫),8431,1975,23,8675,2725,5950,31,1972,1393,579,70,1004,933,92,1321,1152,1695,1309
45,Yokoso Jitsuryoku Shijo v01,3901,1059,27,5143,2207,2936,42,1559,1230,329,78,663,640,96,913,852,1271,1089
46,Yokoso Jitsuryoku Shijo v02,3943,1063,26,4879,2102,2777,43,1551,1223,328,78,640,620,96,901,842,1251,1079
47,Zの時間 (HJ文庫),3038,918,30,5121,2115,3006,41,1639,1256,383,76,610,587,96,885,819,1294,1099
48,Zの時間2 (HJ文庫),3250,930,28,5111,2083,3028,40,1653,1259,394,76,634,604,95,924,841,1355,1134
49,[著者　桜坂洋／挿絵　安倍吉俊] All You Need Is Kill,2635,681,25,6249,2293,3956,36,1687,1258,429,74,685,645,94,954,859,1389,1125
50,[赤城大空] 二度めの夏、二度と会えない君（イラスト完全版）,3881,915,23,5296,2107,3189,39,1573,1226,347,77,603,581,96,903,839,1286,1089
51,【小説1巻】本好きの下剋上～司書になるためには手段を選んでいられません～第一部「兵士の娘I」 (TOブックスラノベ),3567,790,22,5527,2280,3247,41,1658,1296,362,78,736,700,95,1019,929,1369,1154
52,【小説2巻】本好きの下剋上～司書になるためには手段を選んでいられません～第一部「兵士の娘II」 (TOブックスラノベ),3980,835,20,5209,2176,3033,41,1587,1245,342,78,752,712,94,1004,913,1345,1143
53,【小説3巻】本好きの下剋上～司書になるためには手段を選んでいられません～第一部「兵士の娘III」 (TOブックスラノベ),4676,785,16,6179,2382,3797,38,1728,1310,418,75,906,841,92,1166,1043,1464,1205
54,【小説4巻】本好きの下剋上～司書になるためには手段を選んでいられません～第二部「神殿の巫女見習いI」 (TOブックスラノベ),3742,615,16,5799,2299,3500,39,1688,1293,395,76,826,770,93,1089,970,1439,1179
55,【小説5巻】本好きの下剋上～司書になるためには手段を選んでいられません～第二部「神殿の巫女見習いII」 (TOブックスラノベ),3859,519,13,6155,2354,3801,38,1744,1310,434,75,891,815,91,1169,1028,1495,1213
56,いたいのいたいの、とんでゆけ (メディアワークス文庫),2407,564,23,6381,2418,3963,37,1823,1328,495,72,777,736,94,1091,951,1504,1192
57,この素晴らしい世界に祝福を！ 01　あぁ、駄女神さま,2720,518,19,4407,1971,2436,44,1475,1182,293,80,531,510,96,791,736,1188,1030
58,この素晴らしい世界に祝福を！ 02　中二病でも魔女がしたい！,2785,502,18,4423,1949,2474,44,1496,1200,296,80,546,527,96,831,782,1207,1047
59,この素晴らしい世界に祝福を！ 03　よんでますよ、ダクネスさん。,3008,521,17,4607,1964,2643,42,1496,1188,308,79,572,553,96,836,778,1236,1042
60,この素晴らしい世界に祝福を！ 04　鈍ら四重奏　～ナマクラカルテット～,3050,561,18,4565,1944,2621,42,1472,1179,293,80,573,548,95,848,786,1206,1043
61,この素晴らしい世界に祝福を！ 05　爆裂紅魔にレッツ＆ゴー!!,3253,586,18,4625,1978,2647,42,1515,1182,333,78,567,549,96,846,791,1241,1040
62,この素晴らしい世界に祝福を！ 06　六花の王女,3203,542,16,4760,2014,2746,42,1536,1202,334,78,582,563,96,858,803,1244,1051
63,この素晴らしい世界に祝福を！ 07　億千万の花嫁,3136,562,17,4900,2056,2844,41,1559,1210,349,77,597,578,96,892,822,1264,1065
64,この素晴らしい世界に祝福を！ 08　アクシズ教団VSエリス教団,2797,443,15,4718,2033,2685,43,1537,1211,326,78,561,542,96,837,765,1233,1056
65,この素晴らしい世界に祝福を！ 09　紅の宿命,2942,535,18,4562,1951,2611,42,1504,1201,303,79,537,516,96,797,739,1211,1030
66,この素晴らしい世界に祝福を！ 10　ギャンブル・スクランブル！,2921,545,18,4601,1968,2633,42,1526,1201,325,78,552,536,97,843,775,1210,1036
67,この素晴らしい世界に祝福を！ 11　大魔法使いの妹,2724,479,17,4472,1940,2532,43,1510,1182,328,78,526,509,96,802,750,1192,1009
68,この素晴らしい世界に祝福を！ 12　女騎士のララバイ,2707,594,21,4339,1930,2409,44,1514,1197,317,79,498,480,96,782,739,1204,1021
69,この素晴らしい世界に祝福を！ 13　リッチーへの挑戦状,2383,342,14,4409,1906,2503,43,1502,1177,325,78,492,480,97,775,725,1194,1006
70,この素晴らしい世界に祝福を！ 14　紅魔の試練,2548,396,15,4271,1895,2376,44,1455,1147,308,78,478,465,97,748,711,1152,999
71,この素晴らしい世界に祝福を！ 15　邪教シンドローム,2809,583,20,4133,1855,2278,44,1447,1157,290,79,489,473,96,761,709,1146,980
72,この素晴らしい世界に祝福を！ 16　脱走女神、ゴーホーム！,2752,454,16,4682,1940,2742,41,1523,1184,339,77,534,515,96,805,751,1219,1035
73,この素晴らしい世界に祝福を！ 17　この冒険者たちに祝福を！,2374,364,15,3910,1672,2238,42,1351,1077,274,79,448,431,96,696,653,1064,914
74,ただ、それだけでよかったんです (電撃文庫),2513,542,21,4567,2050,2517,44,1560,1215,345,77,566,538,95,856,780,1245,1064
75,キミと僕の最後の戦場、あるいは世界が始まる聖戦 (富士見ファンタジア文庫),3800,813,21,5394,2079,3315,38,1739,1269,470,72,660,613,92,974,847,1433,1131
76,シュガーダーク 埋められた闇と少女 (角川スニーカー文庫),2827,689,24,5477,2121,3356,38,1818,1296,522,71,630,591,93,937,824,1405,1125
77,スライム倒して３００年、知らないうちにレベルＭＡＸになってました (GAノベル),3765,931,24,4630,2147,2483,46,1461,1207,254,82,514,508,98,785,758,1165,1046
78,スライム倒して３００年、知らないうちにレベルＭＡＸになってました２ (GAノベル),3765,775,20,4954,2217,2737,44,1484,1207,277,81,541,534,98,830,795,1207,1076
79,スライム倒して３００年、知らないうちにレベルＭＡＸになってました３ (GAノベル),3663,761,20,4809,2156,2653,44,1452,1212,240,83,506,493,97,786,754,1171,1048
80,ソードアート・オンライン1　アインクラッド (電撃文庫),2905,542,18,6844,2278,4566,33,1839,1295,544,70,804,731,90,1104,947,1510,1171
81,三角の距離は限りないゼロ (電撃文庫),3863,1353,35,4076,1864,2212,45,1342,1095,247,81,445,435,97,670,637,1032,918
82,三角の距離は限りないゼロ２ (電撃文庫),3661,1496,40,3431,1683,1748,49,1250,1038,212,83,401,385,96,613,584,958,865
83,三角の距離は限りないゼロ３ (電撃文庫),3452,1042,30,4026,1838,2188,45,1323,1086,237,82,481,463,96,709,668,1037,918
84,三角の距離は限りないゼロ４ (電撃文庫),3169,1206,38,3532,1760,1772,49,1258,1052,206,83,403,388,96,625,596,954,857
85,僕が電話をかけていた場所 君が電話をかけていた場所 (メディアワークス文庫),1691,287,16,5165,2193,2972,42,1690,1270,420,75,644,613,95,920,840,1344,1110
86,双葉社ジュニア文庫 君の膵臓をたべたい,3152,1211,38,4965,2200,2765,44,1596,1259,337,78,603,590,97,876,825,1274,1103
87,新装版　魔女の宅急便　全６冊合本版 (角川文庫),15297,4522,29,7385,2525,4860,34,1369,1159,210,84,702,677,96,889,831,1160,1036
88,日和ちゃんのお願いは絶対 (電撃文庫),3416,1265,37,3918,1918,2000,48,1369,1144,225,83,465,453,97,702,665,1057,949
89,月光 (電撃文庫),3547,740,20,5450,2170,3280,39,1737,1288,449,74,691,661,95,997,900,1435,1161
90,森の魔獣に花束を（イラスト完全版）,3380,910,26,5080,1982,3098,39,1605,1214,391,75,609,567,93,873,777,1258,1035
91,氷の国のアマリリス (電撃文庫),3907,1207,30,5799,2183,3616,37,1648,1249,399,75,718,675,94,982,878,1358,1125
92,灰と幻想のグリムガル　1,2230,315,14,5832,2094,3738,35,1603,1226,377,76,629,587,93,908,813,1305,1079
93,灰と幻想のグリムガル　2,2748,704,25,4451,1767,2684,39,1388,1106,282,79,444,416,93,700,646,1083,937
94,灰と幻想のグリムガル　3,2534,719,28,4519,1820,2699,40,1412,1126,286,79,452,433,95,698,642,1095,944
95,灰と幻想のグリムガル　4,2928,839,28,5397,1974,3423,36,1564,1193,371,76,531,509,95,795,732,1219,1013
96,灰と幻想のグリムガル　5,2561,625,24,4469,1757,2712,39,1345,1068,277,79,440,421,95,675,625,1030,887
97,灰と幻想のグリムガル　6,2903,645,22,5997,2058,3939,34,1651,1207,444,73,573,543,94,838,767,1275,1049
98,読者と主人公と二人のこれから (電撃文庫),3135,1175,37,4127,1935,2192,46,1367,1117,250,81,453,446,98,709,674,1080,953
99,銀河英雄伝説１　黎明篇 (らいとすたっふ文庫),3278,375,11,8119,2346,5773,28,1990,1334,656,67,917,819,89,1194,1005,1656,1233
100,龍盤七朝　DRAGONBUSTER 01 龍盤七朝 DRAGONBUSTER (電撃文庫),2434,600,24,7467,2202,5265,29,2109,1370,739,64,847,756,89,1225,1028,1734,1271
101,龍盤七朝　DRAGONBUSTER 02 龍盤七朝 DRAGONBUSTER (電撃文庫),2806,756,26,8499,2237,6262,26,2265,1389,876,61,935,831,88,1311,1063,1853,1296
